"a" = (/turf,/area)
"b" = (/turf/wall,/area)
"c" = (/turf/floor,/area)
"d" = (/turf/start,/area)
"e" = (/obj/potato,/turf/floor,/area)
"f" = (/turf/window,/area)
"g" = (/obj/torch,/turf/floor,/area)
"h" = (/obj/lamp,/turf/floor,/area)
"i" = (/mob,/turf/floor,/area)
"j" = (/turf/grass,/area)
"k" = (/turf/water,/area)

(1,1,1) = {"
aaaaaaaaaaaaaaaaaaaaaaaaaaaaaaaaaaaaaaaaaaaaaaaaaa
aaaaaaaaaaaaaaaaaaaaaaaaaaaaaaaaaaaaaaaaaaaaaaaaaa
aaaaaaaaaaaaaaaaaaaaaaaaaaaaaaaaaaaaaaaaaaaaaaaaaa
aaaaaaaaaaaaaaaaaaaaaaaaaaaaaaaaaaaaaaaaaaaaaaaaaa
aaaaaaaaaaaaaaaaaaaaaaaaaaaaaaaaaaaaaaaaaaaaaaaaaa
aaaaaaaaaaaaaaaaaaaaaaaaaaaaaaaaaaaaaaaaaaaaaaaaaa
aaaaaaaaaaaaaaaaaaaaaaaaaaaaaaaaaaaaaaaaaaaaaaaaaa
aaaaaaaaaaaaaaaaaaaaaaaaaaaaaaaaaaaaaaaaaaaaaaaaaa
aaaaaaaaaaaaaaaaaaaaaaaaaaaaaaaaaaaaaaaaaaaaaaaaaa
aaaaaaaaaaaaaaaaaaaaaaaaaaaaaaaaaaaaaaaaaaaaaaaaaa
aaaaaaaaaaaaaaaaaaaaaaaaaaaaaaaaaaaaaaaaaaaaaaaaaa
aaaaaaaaaaaaaaaaaaaaaaaaaaaaaaaaaaaaaaaaaaaaaaaaaa
aaaaaaaaaaaaaaaaaaaaaaaaaaaaaaaaaaaaaaaaaaaaaaaaaa
aaaaaaaaaaaaaaaaaaaaaaaaaaaaaaaaaaaaaaaaaaaaaaaaaa
aaaaaaaaaaaaaaaaaabbbbbbbbbbbbbbbbaaaaaaaaaaaaaaaa
aaaaaaaaaaaaaaaaaabjjjjjjjjjjjjjjbaaaaaaaaaaaaaaaa
aaaaaaaaaaaaaaaaaabjjjjkkkkkjjjjjbaaaaaaaaaaaaaaaa
aaaaaaaaaaaaaaaaaabjjjkkkkkkkjjjjbaaaaaaaaaaaaaaaa
aaaaaaaaaaaaaaaaaabjjjkkkkkkkjjjjbaaaaaaaaaaaaaaaa
aaaaaaaaaaaaaaaaaabjjjjkkkkkjjjjjbaaaaaaaaaaaaaaaa
aaaaaaaaaaaaaaaaaabjjjjjkkjjjjjjjbaaaaaaaaaaaaaaaa
aaaaaaaaaaaaaaaaaabjjjjjjjjjjjjjjbaaaaaaaaaaaaaaaa
aaaaaaaaaaaaaaaaaabbcbbbbbbbbbbbbbaaaaaaaaaaaaaaaa
aaaaaaaaaaaaaaaaaabdccbccccccccccbaaaaaaaaaaaaaaaa
aaaaaaaaaaaaaaaaaabccccccccccbbbcbaaaaaaaaaaaaaaaa
aaaaaaaaaaaaaaaaaabcccbccccccbcccbaaaaaaaaaaaaaaaa
aaaaaaaaaaaaaaaaaabcccbccccccfcccbaaaaaaaaaaaaaaaa
aaaaaaaaaaaaaaaaaabbbbbccccccfcccbaaaaaaaaaaaaaaaa
aaaaaaaaaaaaaaaaaabeeebccccccfcccbaaaaaaaaaaaaaaaa
aaaaaaaaaaaaaaaaaabgggbccccccfcccbaaaaaaaaaaaaaaaa
aaaaaaaaaaaaaaaaaabhhhbccccccbcccbaaaaaaaaaaaaaaaa
aaaaaaaaaaaaaaaaaabccccccccccbbbcbaaaaaaaaaaaaaaaa
aaaaaaaaaaaaaaaaaabiiibccccccccccbaaaaaaaaaaaaaaaa
aaaaaaaaaaaaaaaaaabbbbbbbbbbbbbbbbaaaaaaaaaaaaaaaa
aaaaaaaaaaaaaaaaaaaaaaaaaaaaaaaaaaaaaaaaaaaaaaaaaa
aaaaaaaaaaaaaaaaaaaaaaaaaaaaaaaaaaaaaaaaaaaaaaaaaa
aaaaaaaaaaaaaaaaaaaaaaaaaaaaaaaaaaaaaaaaaaaaaaaaaa
aaaaaaaaaaaaaaaaaaaaaaaaaaaaaaaaaaaaaaaaaaaaaaaaaa
aaaaaaaaaaaaaaaaaaaaaaaaaaaaaaaaaaaaaaaaaaaaaaaaaa
aaaaaaaaaaaaaaaaaaaaaaaaaaaaaaaaaaaaaaaaaaaaaaaaaa
aaaaaaaaaaaaaaaaaaaaaaaaaaaaaaaaaaaaaaaaaaaaaaaaaa
aaaaaaaaaaaaaaaaaaaaaaaaaaaaaaaaaaaaaaaaaaaaaaaaaa
aaaaaaaaaaaaaaaaaaaaaaaaaaaaaaaaaaaaaaaaaaaaaaaaaa
aaaaaaaaaaaaaaaaaaaaaaaaaaaaaaaaaaaaaaaaaaaaaaaaaa
aaaaaaaaaaaaaaaaaaaaaaaaaaaaaaaaaaaaaaaaaaaaaaaaaa
aaaaaaaaaaaaaaaaaaaaaaaaaaaaaaaaaaaaaaaaaaaaaaaaaa
aaaaaaaaaaaaaaaaaaaaaaaaaaaaaaaaaaaaaaaaaaaaaaaaaa
bbbaaaaaaaaaaaaaaaaaaaaaaaaaaaaaaaaaaaaaaaaaaaaaaa
ccbaaaaaaaaaaaaaaaaaaaaaaaaaaaaaaaaaaaaaaaaaaaaaaa
ccbaaaaaaaaaaaaaaaaaaaaaaaaaaaaaaaaaaaaaaaaaaaaaaa
"}
